+0 +0 +0 +0 +0 -1 -1 -1 -1 -1 -1 -1 -1 -1 -1 -1 -1 -1 -1 -1 -1 -1 -1 -1 -1 -1 -1 -1 -1 -1 -1 -1 -1 -1 -1
+0 +1 +1 +1 +0 -1 -1 -1 -1 -1 -1 -1 -1 -1 -1 -1 -1 -1 -1 -1 -1 -1 -1 -1 -1 -1 -1 -1 -1 +0 +0 +0 +0 +0 +0
+0 +1 +0 +1 +0 -1 -1 -1 -1 -1 -1 +0 +0 +0 +0 +0 +0 +0 +5 +6 +5 +0 +0 -1 -1 -1 -1 -1 -1 +0 +5 +5 +5 +5 +0
+0 -2 +1 +1 +1 +2 +2 +2 +2 +2 +2 +1 +1 +1 +1 +5 +5 +5 +5 +6 +5 +5 +8 10 +9 +9 10 +9 +9 +5 +5 +5 +7 +5 +0
+0 +0 +0 +0 +0 -1 -1 -1 -1 -1 -1 +0 +0 +0 +0 +0 +0 +0 +5 +6 +5 +0 +0 -1 -1 -1 -1 -1 -1 +0 +5 +5 +5 +5 +0
-1 -1 -1 -1 -1 -1 -1 -1 -1 -1 -1 -1 -1 -1 -1 -1 -1 -1 -1 -1 -1 -1 -1 -1 -1 -1 -1 -1 -1 +0 +0 +0 +0 +0 +0
