22222222222
20000022222
20222022222
20232020000
20002020222
22220020222
22220220222
22220000222
22222222222