55555555555555555555555555555555655555
55555555555555555555555555555555155555
55555555555555555555555555555555155555
55555555555555555555555555555555155555
55555555555555555555555555555555155555
55555555555555555555555555555555155555
55555555555555555555555555555555155555
55555555555555555555555555555555155555
55555555555555555555555555555555155555
55555555555555555555555555555555155555
55555555555555555555555555555555155555
55555555555555555555555555555555155555
55555555555555555555555555555555155555
55555555555555555555555555555555155555
55555555555555555555555555555555155555
55555555555555555555555555555555155555
55555555555555555555555555555555155555
55555555555555555555555555555555155555
55555555555555555555555555555555155555
55555555555555555555555555555555155555
55555555555555555555555555555555155555
55555555555555555555555555555555155555
55555555555555555555555555555555155555
55555555555555555555555555555555155555
55555555555555555555555555555555155555
55555555555555555555555555555555155555
55555555555555555555555555555555155555
55555555555555555555555555555555155555
55555555555555555555555555555555155555
55555555555555555555555555555555155555
55555555555555555555555555555555155555
55555555555555555555555555555555155555
55555555555555555555555555555555155555
55555555555555555555555555555555155555
55555555555555555555555555555555155555
55555555555555555555555555555555155555
55555555555555555555555555555555155555
55555555555555555555555555555555155555
55555555555555555555555555555555155555
55555555555555555555555555555555155555
55555555555555555555555555555555155555
55555555555555555555555555555555155555
55555555555555555555555555555555155555
55555555555555555555555555555555155555
55555555555555555555555555555555155555
55555555555555555555555555555555155555
55555555555555555555555555555555155555
55555555555555555555555555555555155555
55555555555555555555555555555555155555
55555555555555555555555555555555155555
55555555555555555555555555555555155555
55555555555555555555555555555555155555
55555555555555555555555555555555155555
55555555555555555555555555555555155555
55555555555555555555555555555555155555
55555555555555555555555555555555155555
55555555555555555555555555555555155555
55555555555555555555555555555555155555
55555555555555555555555555522222022222
55555555555555555555555555522000000022
55555555555555555555555555522022022022
55555555555555555555555555522000020022
55555555555555555555555555522222220222
55555555555555555555555555520002220002
55555555555555555555555555520202220202
55555555555555555555555555520202220202
55555555555555555555555555520200000202
55555555555555555555555555520222220202
55555555555555555555555555520000020002
55555555555555555555555555522222022222
55555555555555555555555555555555155555
55555555555555555555555555555555155555
55555555555555555555555555555555155555
55555555555555555555555555555555155555
55555555555555555555555555555555155555
55555555555555555555555555555555155555
55555555555555555555555555555555155555
55555555555555555555555555555555155555
55555555555555555555555555555555155555
55555555555555555555555555555555155555
55555555555555555555555555555555155555
55555555555555555555555555555555155555
55555555555555555555555555555555155555
55555555555555555555555555555555155555
55555555555555555555555555555555155555
55555555555555555555555555555555155555
55555555555555555555555555555555155555
55555555555555555555555555555555155555
55555555555555555555555555555555155555
55555555555555555555555555555555155555
55555555555555555555555555555555155555
55555555555555555555555555555555155555
55555555555555555555555555222222022255
22222222555555555555555555222222022255
20002002555555555555555555222200000255
20202002555555555555555555222202020255
20200002555555555555555555222200020255
20222200111111111111111111002222220255
20000222555555555555555555202222220255
22220222555555555555555555200000000255
22223222555555555555555555222222222255
22222222555555555555555555555555555555